1111111111111111111
1000000000000000001
1000E00000000000001
100C000000000000001
1CCCCC0P00011111111
100C00000011C0010E1
10000000011C0001001
1000000001CC0000001
1000000000000C00001
1111111111111111111